#################################################################################################################################
# ___ ___ ___ ___ ___ _ ____ ____ ____ ____ ____ ____ ____ ____ ____ ____ ____ ____ ____ ____ ____ ____ ____ ____ ____ ____ ____#
#_| |_| |_| |_| |_| |_|_|  |_|  |_|  |_|  |_|  |_|  |_|  |_|  |_|  |_|  |_|  |_|  |_|  |_|  |_|  |_|  |_|  |_|  |_|  |_|  |_|  |#
#                                                                                                                               #
#_______________________________________________________________________________________________________________________________#
#@@@@@@@@@@@@@@@@@@@@@@@@@@@@@@@@@@@@@@@@@@@@@@@@@@@@@@@@@@@@@@@@@@@@@@@@@@@@@@@@@@@@@@@@@@@@@@@@@@@@@@@@@@@@@@@@@@@@@@@@@@@@@@@#
#                                                                                                                               #
#                                                                                                                               #
#                                                                                                                               #
#                                                                                                                               #
#                                                                                                                               #
#                                                                                                                               #
#                                                                                                                               #
#                                                                                                                               #
#                                                                                                                               #
#                                                                                                                               #
#                                                                                                                               #
#                                                                                                                               #
#                                                                                                                               #
#                                                                                                                               #
#                                                                                                                               #
#                                                                                                                               #
#                                                                                                                               #
#                                                                                                                               #
#                                                                                                                               #
#                                                                                                                               #
#                                                                                                                               #
#                                                                                                                               #
#                                                                                                                               #
#                                                                                                                               #
#                                                                                                                               #
#################################################################################################################################