#################################################################################################################################
#   @|  |@                                                                                                                      #
#   @\  \@                                                                                                                      #
#   @/  /@                                                                                                                      #
#   @|  |@                                                                                                                      #
#   @\  \@                                                                                                                      #
#    @\  \@                                                                                                                     #
#     @\  \@                                                                                                                    #
#     @|   \@                                                                                                                   #
#     @\   /@                                                                                                                   #
#      @\ |@                                                                                                                    #
#       @\ \@                                                                                                                   #
#       @| |@                                                                                                                   #
#      @/  /@                                                                                                                   #
#     @/  /@                                                                                                                    #
#    @/  /@                                                                                                                     #
#    @\  \@                                                                                                                     #
#    @|  |@                                                                                                                     #
#    @|  |@                                                                                                                     #
#    @|  |@                                                                                                                     #
#    @\  \@                                                                                                                     #
#    @/  /@                                                                                                                     #
#   @/  /@                                                                                                                      #
#   @\  \@                                                                                                                      #
#   @/  /@                                                                                                                      #
#   @|  |@                                                                                                                      #
#   @|  |@                                                                                                                      #
#   @|  |@                                                                                                                      #
#   @|  |@                                                                                                                      #
#   @|  |@                                                                                                                      #
#   @|  |@                                                                                                                      #
#################################################################################################################################