#################################################################################################################################
#                                                                                                                               #
#                                                                                                                               #
#                                                                                                                               #
#                                                                                                                               #
#                                                                                                                               #
#                                                                                                                               #
#                                                                                                                               #
#                                                                                                                               #
#                                                                                                                               #
#  loc5.txt                                                                                                                     #
#                                                                                                                               #
#                                                                                                                               #
#                                                                                                                               #
#                                                                                                                               #
#                                                                                                                               #
#                                                                                                                               #
#                                                                                                                               #
#                                                                                                                               #
#                                                                                                                               #
#                                                                                                                               #
#                                                                                                                               #
#                                                                                                                               #
#                                                                                                                               #
#                                                                                                                               #
#                                                                                                                               #
#                                                                                                                               #
#                                                                                                                               #
#                                                                                                                               #
#                                                                                                                               #
#                                                                                                                               #
#################################################################################################################################