#################################################################################################################################
#                                                                                                                       @/ /@   #
#                                                                                                                      @/ /@    #
#                                                                                                                     @/ /@     #
#                                                                                                                     @\ \@     #
#                                                                                                                     @/ /@     #
#                                                                                                                     @| |@     #
#                                                                                                                     @| |@     #
#                                                                                                                     @| \@     #
#                                                                                                                      @\ \@    #
#                                                                                                                       @\ \@   #
#                                                                                                                        @\ \@  #
#                                                                                                                        @| |@  #
#                                                                                                                        @| |@  #
#                                                                                                                        @/ /@  #
#                                                                                                                       @/ /@   #
#                                                                                                                      @/ /@    #
#                                                                                                                      @\ \@    #
#                                                                                                                       @\ \@   #
#                                                                                                                        @\ \@  #
#                                                                                                                        @/ /@  #
#                                                                                                                        @| |@  #
#                                                                                                                        @/ /@  #
#                                                                                                                       @/ /@   #
#                                                                                                                      @/ /@    #
#                                                                                                                     @/ /@     #
#                                                                                                                     @\ \@     #
#                                                                                                                      @\ \@    #
#                                                                                                                       @\ \@   #
#                                                                                                                       @/ /@   #
#                                                                                                                       @| |@   #
#################################################################################################################################