---------------------------------------------------------------------..::::-.--+/---.----.-----------:+/////:////////////////////////////////////
------------------------:.:-----------------------------------------../-y--y-./++/.//:/.:/:/-.------:+/////::////////////////////////////////////
-----------------------.-/-/:://:/-.-----------:---------------------...s.o/.:o:.y.//:o.-o.-y..---:/+////-://////////////////////////////////////
------------------------.-.----....-------------:------------------:----y--s-/s/:+-+/:o-:s::+-:/++//////::///////////////////////////////////////
-----------------------------------------------------------------------::--:--::/++o+/+//////////////:-://///////////////////////////////////////
----------:------------------------:--------------------------------------------//:+///////////////::////////////////////////////////////////////
----------:--------&------------------------------.----...-.-------:----------/++////:-:///////////-:////////////////////////////////////////////
------------:-----&M&------&----------------------.-/::/-:/:-::/.----:------:+///////////:-///////://////////////////////////////////////////////
-------------:----&M&-----&M&-------:---------------:-:--::-----.----------:+/////////////:/::///:://////////////////////////////////////////////
-------------:----&MM&&--&MM&----------------------------------------------//////////////////:://:///////////////////////////////////////////////
-------------:-----&MMM&&M&------------------------------------------------/////////////////////--///////////////////////////////////////////////
--------------:-----&MMMMM&----------:-------------------------------------///++///////////////////::////////////////////////////////////////////
---------------:----&MMMM&------------------------------------------------///-::////::::::///++////::////////////////////////////////////////////
----------------:--&MM&&&--Ã√À»—“€≈--------------------------------------//\\------------------::/+///-://///////////////////////////////////////
-----------------:&MM&%%%%¬≈–ÿ»Õ€--%---%--------------------------------/--//\_--------Œ–«›ƒ------:+/////////////////////////////////////////////
------------------:&MM%&--%-------%-%-%-%--------- ÀŒÕ“Œ –»ƒ∆---_______/\--|---\-------*****-----:++//:-/////////////////////////////////////////
------------------/-&%M&--%%%%%--%---%---%----------*****------/--\--------/---%B%%%%%%*   *----/+////:://///////////////////////////////////////
----------...------:&MMM&------%%---------%---------*   *%%%%%B%%%%B%-----/--%%-|------*****::/+////:-///////////////////////////////////////////
---------.-::-:----/&MM&---.---------------%--------*****----/----/|-%-----%%---\-------/+//////////::///////////////////////////////////////////
---------.-::-:&:://&MM&:::.----------------%--------%-------\---/--\-%%--%------\-----+///////////::////////////////////////////////////////////
--------------&M&&-:/&MM&---------------___-%--------%%-------\------\--%%-------------++//////////::////////////////////////////////////////////
--------------&MMM&-/&&MM&-------------////\-%------%--%------/------/\--%--------------/+////////:://///////////////////////////////////////////
---------------&&MMM&MMMM&------------//////|%-----%----%----/--------%B%%%--¡–Œ’»–ƒ----//++/////::://///////////////////////////////////////////
-----::://:::----&MMMMMMMM&----------|///////-%---%------%---\-------%-/---%%%*****---:+/////////:://////////////////////////////////////////////
---/+////////++---&&MMMMMM&----------|/////---%%%---------%--—»Õ»…--%-/\------*   *--------/+////:://////////////////////////////////////////////
--+///////////+/::&MM&MMMMM&----------\///\---Œ«≈–Œ--------%---À≈—-%--\-------*****--------++///::///////////////////////////////////////////////
:+////////////o:-&MM&&M&&MMM&----------\///-œ–¿¬ƒ€----------%-^^^^%---/--------------:::-:/+////::///////////////////////////////////////////////
+////////////+/-&MM&-&M&-&MMM&----------|/-----------------%-^^^^^^^-/------------/////////////::////////////////////////////////////////////////
////////////+/&MMM&---&M&-&MMM&-----------------------------%--^^^^_/-----------/+/////////////-/////////////////////////////////////////////////
////////////:--&&&-----&---&&M&----------------------------%--^^^-^-----------/+////:://////::///////////////////////////////////////////////////
///////+/:-------------------&M&--------------------------%----------------:/+/////:::/:-://::///////////////////////////////////////////////////
////+//------------.----------&M&------------------------%-------------://+/////:-///////////////////////////////////////////////////////////////
+/--/-/::/:::::/-/-.-----------&-------------------------%----------:/++///////:::///////////////////////////////////////////////////////////////
/---------::---------------------------------------------%-√≈ƒ∆---:/++////////:-/////////////////////////////////////////////////////////////////
----------------------------------------------------------%*****-/++/////////::://///////////////////////////////////////////////////////////////
/----------------------------------------------------------*   *-//://://///:-///////////////////////////////////////////////////////////////////
++/:------------------------------:------------------------*****-/+:///////::////////////////////////////////////////////////////////////////////
////+///:--------------------------------------------------------:+/:-:///:-/////////////////////////////////////////////////////////////////////
/////////+/:------------------------------------------------------+//::///:://///////////////////////////////////////////////////////////////////
/:://///////+//:------------------:-------------------------------:+///:-/-/////////////////////////////////////++++/////////////////////////////
++::/::////////++/////////:----------------------------------------/+///:/://///////////////////////////////+/::---:+////////////////////////////
-/+//::/://////////////////+/:--------------------://++/:-----------:++////-//////////////////////////////+/--------/+///////////////////////////
--:+////-:///////////////////++/----------------/++/////+/-------------:/+/:://///////////////////////////o:--------:+///////////////////////////
---/+////:/:://///////////////+/--------------:+//////////+/:------------/+/::////////////////////////////+---------/+///////////////////////////
---:o//////:-////////////////+/--------------/+/////////////++/:---------/+/::///////////////////////////+/---------++///////////////////////////
----+/////////-:///////////++:--------------/+/////////////////++//::://+//::///////////////////////////+:---------:o////////////////////////////
---:+/////////:://////////+/--------------:++///////:/::://///////////////::///////////////////////////+:----------/+////////////////////////////
--:+////////////-://////+/---------------++////////--//::/:-://::///://:-:////////////////////////////+/----------:+/////////////////////////////
-:+//:.-:////////://///+:--------------:+////////:://///////://:://:::///////////////////////////////+/----------:+//////////////////////////////
-+//:....:+///////::///+--------------:+/////////-:////////////////////////////////////////////////++:-----------+///////////////////////////////
-o//:...../+///////:////+:-----------/+/////////://///////////////////////////////////////////////+/------------/+///////////////////////////////
-/+//osssss+////////:-///+/--------:++/////////-://///////////////////////////////////////////////+/------------+////////////////////////////////
-:+//////////////////:////++/////++//////////::////////////////////////////////////////////////////++:---------++////////////////////////////////
-/+///////////////////:-////////////////////:-///////////////////////////////////////////////////////++//::://+//:///////////////////////////////